date,neutral_count,positive_count,negative_count,total,neutral_count_pct,positive_count_pct,negative_count_pct
2020-02-01,74,107,108,289,25.60553633217993,37.0242214532872,37.37024221453287
2020-02-02,97,155,150,402,24.129353233830848,38.55721393034826,37.3134328358209
2020-02-03,176,206,223,605,29.09090909090909,34.049586776859506,36.85950413223141
2020-02-04,139,151,197,487,28.54209445585216,31.006160164271044,40.4517453798768
2020-02-05,72,87,139,298,24.161073825503358,29.194630872483224,46.644295302013425
2020-02-06,60,78,143,281,21.352313167259787,27.75800711743772,50.88967971530249
2020-02-07,48,68,147,263,18.250950570342205,25.85551330798479,55.893536121673
2020-02-08,39,41,117,197,19.796954314720814,20.812182741116754,59.390862944162436
2020-02-09,45,57,127,229,19.65065502183406,24.890829694323145,55.45851528384279
2020-02-10,31,61,78,170,18.235294117647058,35.88235294117647,45.88235294117647
2020-02-11,33,46,78,157,21.019108280254777,29.29936305732484,49.681528662420384
2020-02-12,32,45,83,160,20.0,28.125,51.87500000000001
2020-02-13,57,61,80,198,28.78787878787879,30.808080808080806,40.4040404040404
2020-02-14,26,39,60,125,20.8,31.2,48.0
2020-02-15,48,31,78,157,30.573248407643312,19.745222929936308,49.681528662420384
2020-02-16,36,28,73,137,26.277372262773724,20.437956204379564,53.284671532846716
2020-02-17,33,47,51,131,25.190839694656486,35.87786259541985,38.93129770992366
2020-02-18,70,42,142,254,27.559055118110237,16.535433070866144,55.90551181102362
2020-02-19,28,35,80,143,19.58041958041958,24.475524475524477,55.94405594405595
2020-02-20,59,43,75,177,33.33333333333333,24.293785310734464,42.3728813559322
2020-02-21,31,34,75,140,22.142857142857142,24.285714285714285,53.57142857142857
2020-02-22,26,32,53,111,23.423423423423422,28.82882882882883,47.74774774774775
2020-02-23,36,26,61,123,29.268292682926827,21.138211382113823,49.59349593495935
2020-02-24,23,36,61,120,19.166666666666668,30.0,50.83333333333333
2020-02-25,28,35,39,102,27.450980392156865,34.31372549019608,38.23529411764706
2020-02-26,31,44,68,143,21.678321678321677,30.76923076923077,47.55244755244755
2020-02-27,46,51,71,168,27.380952380952383,30.357142857142854,42.26190476190476
2020-02-28,35,80,67,182,19.230769230769234,43.956043956043956,36.81318681318682
2020-02-29,37,55,68,160,23.125,34.375,42.5
2020-03-01,33,53,80,166,19.879518072289155,31.92771084337349,48.19277108433735
2020-03-02,63,107,125,295,21.35593220338983,36.271186440677965,42.3728813559322
2020-03-03,75,185,221,481,15.592515592515593,38.46153846153847,45.94594594594595
2020-03-04,98,222,259,579,16.92573402417962,38.34196891191709,44.73229706390328
2020-03-05,124,179,267,570,21.75438596491228,31.403508771929822,46.8421052631579
2020-03-06,88,147,242,477,18.448637316561843,30.81761006289308,50.73375262054507
2020-03-07,67,122,154,343,19.533527696793,35.56851311953353,44.89795918367347
2020-03-08,70,133,138,341,20.527859237536656,39.002932551319645,40.469208211143695
2020-03-09,125,170,275,570,21.929824561403507,29.82456140350877,48.24561403508772
2020-03-10,111,181,163,455,24.395604395604394,39.78021978021978,35.824175824175825
2020-03-11,86,230,230,546,15.75091575091575,42.124542124542124,42.124542124542124
2020-03-12,104,229,275,608,17.105263157894736,37.66447368421053,45.23026315789473
2020-03-13,109,307,341,757,14.398943196829592,40.554821664464995,45.04623513870541
2020-03-14,120,323,445,888,13.513513513513514,36.373873873873876,50.112612612612615
2020-03-15,137,409,368,914,14.989059080962802,44.74835886214442,40.26258205689278
2020-03-16,225,522,568,1315,17.110266159695815,39.69581749049429,43.19391634980988
2020-03-17,287,583,572,1442,19.902912621359224,40.429958391123435,39.66712898751734
2020-03-18,122,301,312,735,16.598639455782312,40.95238095238095,42.44897959183673
2020-03-19,149,288,259,696,21.408045977011493,41.37931034482759,37.212643678160916
2020-03-20,168,457,436,1061,15.83411875589067,43.07257304429783,41.0933081998115
2020-03-21,163,366,430,959,16.99687174139729,38.16475495307612,44.83837330552659
2020-03-22,222,770,586,1578,14.068441064638785,48.79594423320659,37.135614702154626
2020-03-23,469,1275,927,2671,17.558966679146387,47.73493073755148,34.70610258330213
2020-03-24,445,1100,831,2376,18.72895622895623,46.2962962962963,34.974747474747474
2020-03-25,285,667,557,1509,18.886679920477135,44.20145791915176,36.91186216037111
2020-03-26,518,1312,1093,2923,17.72151898734177,44.88539172083476,37.393089291823465
2020-03-27,474,1111,849,2434,19.474116680361544,45.64502875924404,34.88085456039441
2020-03-28,484,1322,1014,2820,17.163120567375888,46.87943262411348,35.95744680851064
2020-03-29,504,1292,1052,2848,17.696629213483146,45.36516853932584,36.93820224719101
2020-03-30,812,1478,1405,3695,21.975642760487144,40.0,38.02435723951286
2020-03-31,752,1460,1213,3425,21.956204379562045,42.627737226277375,35.41605839416058
2020-04-01,546,1610,1164,3320,16.44578313253012,48.493975903614455,35.06024096385542
2020-04-02,600,1478,1198,3276,18.315018315018314,45.11599511599512,36.56898656898657
2020-04-03,670,1335,1132,3137,21.357985336308573,42.55658272234619,36.085431941345234
2020-04-04,491,1226,979,2696,18.212166172106826,45.474777448071215,36.31305637982196
2020-04-05,530,1428,1039,2997,17.684351017684353,47.647647647647645,34.668001334668006
2020-04-06,751,1879,1276,3906,19.226830517153097,48.10547875064004,32.667690732206864
2020-04-07,603,1605,1137,3345,18.026905829596412,47.98206278026906,33.99103139013453
2020-04-08,567,1575,1143,3285,17.26027397260274,47.94520547945205,34.794520547945204
2020-04-09,660,1401,1167,3228,20.44609665427509,43.40148698884758,36.152416356877325
2020-04-10,551,1184,954,2689,20.490888806247675,44.031238378579395,35.47787281517293
2020-04-11,389,1089,858,2336,16.652397260273975,46.61815068493151,36.72945205479452
2020-04-12,468,1050,781,2299,20.35667681600696,45.67203131796433,33.97129186602871
2020-04-13,749,1333,1042,3124,23.975672215108833,42.6696542893726,33.35467349551857
2020-04-14,729,1829,1219,3777,19.301032565528196,48.42467566851999,32.274291765951816
2020-04-15,565,1357,1080,3002,18.82078614257162,45.20319786808794,35.97601598934044
2020-04-16,651,1608,1228,3487,18.669343275021507,46.114138227702895,35.216518497275594
2020-04-17,514,1276,1036,2826,18.18825194621373,45.152158527954704,36.659589525831564
2020-04-18,563,1380,1085,3028,18.59313077939234,45.574636723910174,35.83223249669749
2020-04-19,504,1388,1262,3154,15.979708306911858,44.00760938490805,40.01268230818009
2020-04-20,458,1143,1011,2612,17.534456355283307,43.75957120980092,38.70597243491577
2020-04-21,613,1522,1149,3284,18.666260657734473,46.34591961023142,34.987819732034104
2020-04-22,463,1316,920,2699,17.15450166728418,48.75879955539089,34.08669877732493
2020-04-23,441,1487,932,2860,15.41958041958042,51.99300699300699,32.58741258741259
2020-04-24,407,1166,892,2465,16.511156186612578,47.302231237322516,36.18661257606491
2020-04-25,470,1146,803,2419,19.429516329061595,47.374948325754445,33.19553534518396
2020-04-26,454,1253,1007,2714,16.72807663964628,46.16801768607222,37.1039056742815
2020-04-27,451,1281,972,2704,16.678994082840237,47.374260355029584,35.946745562130175
2020-04-28,443,1176,888,2507,17.67052253689669,46.90865576386119,35.420821699242126
2020-04-29,389,1115,968,2472,15.736245954692556,45.105177993527505,39.15857605177994
2020-04-30,407,1147,800,2354,17.289719626168225,48.72557349192863,33.98470688190314
