date,neutral_count,positive_count,negative_count,total,neutral_count_pct,positive_count_pct,negative_count_pct
2020-02-01,78,126,96,300,26.0,42.0,32.0
2020-02-02,113,127,148,388,29.12371134020619,32.7319587628866,38.144329896907216
2020-02-03,77,60,76,213,36.15023474178404,28.169014084507044,35.68075117370892
2020-02-04,122,85,121,328,37.19512195121951,25.914634146341463,36.890243902439025
2020-02-05,69,96,114,279,24.731182795698924,34.40860215053764,40.86021505376344
2020-02-06,76,63,104,243,31.275720164609055,25.925925925925924,42.79835390946502
2020-02-07,105,68,119,292,35.95890410958904,23.28767123287671,40.75342465753425
2020-02-08,90,66,85,241,37.344398340248965,27.385892116182575,35.26970954356847
2020-02-09,63,54,110,227,27.75330396475771,23.788546255506606,48.458149779735685
2020-02-10,67,107,103,277,24.187725631768952,38.628158844765345,37.18411552346571
2020-02-11,33,70,62,165,20.0,42.42424242424242,37.57575757575757
2020-02-12,53,86,70,209,25.358851674641148,41.14832535885167,33.49282296650718
2020-02-13,79,112,145,336,23.511904761904763,33.33333333333333,43.154761904761905
2020-02-14,40,75,90,205,19.51219512195122,36.58536585365854,43.90243902439025
2020-02-15,77,70,81,228,33.771929824561404,30.701754385964914,35.526315789473685
2020-02-16,78,76,132,286,27.27272727272727,26.573426573426573,46.15384615384615
2020-02-17,89,102,119,310,28.70967741935484,32.903225806451616,38.387096774193544
2020-02-18,71,62,95,228,31.140350877192986,27.192982456140353,41.66666666666667
2020-02-19,72,44,76,192,37.5,22.916666666666664,39.58333333333333
2020-02-20,49,49,99,197,24.873096446700508,24.873096446700508,50.25380710659898
2020-02-21,49,53,84,186,26.344086021505376,28.49462365591398,45.16129032258064
2020-02-22,39,37,54,130,30.0,28.46153846153846,41.53846153846154
2020-02-23,61,60,120,241,25.311203319502074,24.896265560165975,49.79253112033195
2020-02-24,50,67,94,211,23.696682464454977,31.753554502369667,44.54976303317535
2020-02-25,62,54,61,177,35.02824858757062,30.508474576271187,34.463276836158194
2020-02-26,52,49,76,177,29.37853107344633,27.683615819209038,42.93785310734463
2020-02-27,106,81,87,274,38.68613138686132,29.56204379562044,31.751824817518248
2020-02-28,57,94,94,245,23.26530612244898,38.36734693877551,38.36734693877551
2020-02-29,46,66,90,202,22.772277227722775,32.67326732673268,44.554455445544555
2020-03-01,35,67,92,194,18.04123711340206,34.5360824742268,47.42268041237113
2020-03-02,59,80,94,233,25.321888412017167,34.33476394849785,40.343347639484975
2020-03-03,124,119,168,411,30.170316301703163,28.953771289537713,40.87591240875913
2020-03-04,123,217,202,542,22.693726937269375,40.03690036900369,37.269372693726936
2020-03-05,106,129,163,398,26.633165829145728,32.41206030150754,40.95477386934673
2020-03-06,123,126,140,389,31.619537275064268,32.390745501285345,35.98971722365039
2020-03-07,97,127,150,374,25.935828877005346,33.9572192513369,40.106951871657756
2020-03-08,248,211,300,759,32.674571805006586,27.79973649538867,39.52569169960474
2020-03-09,199,230,276,705,28.22695035460993,32.62411347517731,39.148936170212764
2020-03-10,289,263,396,948,30.485232067510548,27.742616033755276,41.77215189873418
2020-03-11,227,339,339,905,25.082872928176798,37.4585635359116,37.4585635359116
2020-03-12,292,467,412,1171,24.93595217762596,39.880444064901795,35.18360375747225
2020-03-13,296,536,483,1315,22.509505703422054,40.760456273764255,36.73003802281369
2020-03-14,315,528,527,1370,22.99270072992701,38.54014598540146,38.46715328467153
2020-03-15,431,837,641,1909,22.57726558407543,43.84494499738083,33.57778941854374
2020-03-16,559,1100,854,2513,22.24432948666932,43.772383605252685,33.98328690807799
2020-03-17,694,1272,837,2803,24.759186585800926,45.37995005351409,29.86086336068498
2020-03-18,388,841,565,1794,21.627647714604237,46.878483835005575,31.49386845039019
2020-03-19,430,836,525,1791,24.00893355667225,46.67783361250698,29.313232830820766
2020-03-20,648,1532,849,3029,21.39319907560251,50.57774843182569,28.029052492571804
2020-03-21,698,1880,1097,3675,18.993197278911563,51.156462585034014,29.85034013605442
2020-03-22,1701,3850,1895,7446,22.844480257856567,51.70561375235025,25.449905989793177
2020-03-23,4820,9190,5561,19571,24.628276531602882,46.95723264013081,28.414490828266313
2020-03-24,9174,17686,8007,34867,26.311411936788364,50.7241804571658,22.96440760604583
2020-03-25,4953,11631,5097,21681,22.844887228448872,53.646049536460495,23.509063235090633
2020-03-26,5812,13373,6415,25600,22.703125,52.23828124999999,25.058593750000004
2020-03-27,5332,12419,5924,23675,22.521647307286166,52.45617740232312,25.02217529039071
2020-03-28,6738,15958,8537,31233,21.573335894726732,51.09339480677488,27.33326929849838
2020-03-29,5546,12848,7124,25518,21.733678187945763,50.34877341484443,27.917548397209814
2020-03-30,6054,12907,7101,26062,23.229222622975982,49.52421149566418,27.246565881359835
2020-03-31,4731,10582,5772,21085,22.437751956367087,50.187336969409536,27.37491107422338
2020-04-01,4052,9251,4803,18106,22.37932177178836,51.09356014580801,26.52711808240362
2020-04-02,4229,10994,5527,20750,20.380722891566265,52.98313253012048,26.636144578313253
2020-04-03,4657,10346,4425,19428,23.970557957586987,53.25303685402511,22.776405188387894
2020-04-04,4238,9164,3976,17378,24.387156174473475,52.73334100586949,22.879502819657038
2020-04-05,4022,9201,3940,17163,23.43413156208122,53.609508827128124,22.956359610790656
2020-04-06,3519,8735,3816,16070,21.89794648413192,54.35594275046671,23.74611076540137
2020-04-07,4087,10197,4072,18356,22.265199389845282,55.55131837001526,22.183482240139462
2020-04-08,4547,10577,4362,19486,23.33470183721646,54.27999589448835,22.385302268295188
2020-04-09,4036,10271,4278,18585,21.716437987624428,55.26499865482917,23.01856335754641
2020-04-10,4068,10441,4489,18998,21.412780292662386,54.95841667543952,23.628803031898094
2020-04-11,5001,10936,4465,20402,24.512302715420056,53.60258798157044,21.885109303009507
2020-04-12,3979,9424,4362,17765,22.39797354348438,53.048128342245995,24.553898114269632
2020-04-13,4736,10419,4384,19539,24.23870208301346,53.32412098879165,22.437176928194894
2020-04-14,7192,14354,6335,27881,25.795344499838603,51.48308884186363,22.721566658297764
2020-04-15,4343,8624,3963,16930,25.65268753691672,50.939161252215,23.40815121086828
2020-04-16,5012,12346,5604,22962,21.827366954098075,53.767093458757955,24.405539587143977
2020-04-17,4130,9549,4512,18191,22.70353471496894,52.49299103952504,24.803474245506017
2020-04-18,3291,8722,3726,15739,20.909841794269013,55.4164813520554,23.67367685367558
2020-04-19,3738,8858,4120,16716,22.36180904522613,52.99114620722661,24.647044747547262
2020-04-20,3623,8594,3995,16212,22.347643720700717,53.01011596348384,24.642240315815446
2020-04-21,4105,10052,4926,19083,21.511292773672903,52.67515589791961,25.813551328407485
2020-04-22,3536,9091,3824,16451,21.49413409519178,55.261078353899464,23.24478755090876
2020-04-23,3366,8703,3727,15796,21.309192200557103,55.09622689288427,23.594580906558623
2020-04-24,3550,9437,3738,16725,21.225710014947683,56.42451420029896,22.349775784753366
2020-04-25,3727,9492,3995,17214,21.650981759033343,55.141164168699895,23.20785407226676
2020-04-26,3495,9623,3968,17086,20.455343556127826,56.32096453236568,23.223691911506496
2020-04-27,4258,9523,4093,17874,23.82231173771959,53.27850509119392,22.899183171086495
2020-04-28,3757,8651,3830,16238,23.137085848010837,53.27626554994458,23.586648602044587
2020-04-29,3172,7628,3322,14122,22.461407732615776,54.01501203795497,23.523580229429257
2020-04-30,3119,7321,3228,13668,22.81972490488733,53.56306701785192,23.617208077260756
